3 13 31
###############################
#p   ** **    *   2           #
# # # #*# # # # # # # # # # # #
#6     *  * *  *   s *  3 *   #
# # # # # #*# # # # # # #*# # #
#    *s*    *   * x *         #
# # # # # # # # # # # # # #f# #
#  6 f     *  4     *    **  6#
# # # # #*# # #*# # #1# # #*# #
#                             #
#*# # # # # # # # # # # # # #*#
# *    * m*    s* *f*     1   #
###############################