5 13 31
###############################
#p * *4       *  ** * *      *#
# # # # #*# # #*# # # # # #*# #
#mx  * * s** f*      *    **  #
# #*# # # # #4# #bx1  # # # #*#
#          *     **      *  **#
# # #*# 7 # # # #*#*#*#*# # # #
#   *        *   * *x* *   4  #
# # # # #f# 6 # # # # #*# #*# #
#   ****         *2           #
# # # # # # # # # #*# # # # #*#
#  ** *5  *                   #
###############################