2 13 31
###############################
#p                            #
# # # # # # # # # # # # # # # #
#         m  f            f   #
# #*# # # # # # #b# # # # # #*#
#       1  *     **      *  *s#
# # #*# # # # # #*#*#*#*# # # #
#   *        *   * *x* *      #
# # # # #*# # # # # # #*# #*# #
#   x*m*         *            #
# # # # # # # # # #*# # # # #f#
#  f* *   *                   #
###############################